Arabic 	Semitic Branch 	Afro-Asiatic
Maltese 	Semitic Branch 	Afro-Asiatic
Hebrew 	Semitic Branch 	Afro-Asiatic
Amharic 	Semitic Branch 	Afro-Asiatic
Tigrinya 	Semitic Branch 	Afro-Asiatic
Tigre 	Semitic Branch 	Afro-Asiatic
Aramaic 	Semitic Branch 	Afro-Asiatic
Gurage 	Semitic Branch 	Afro-Asiatic
Harari 	Semitic Branch 	Afro-Asiatic
Geez 	Semitic Branch 	Afro-Asiatic
Syriac 	Semitic Branch 	Afro-Asiatic
Akkadian 	Semitic Branch 	Afro-Asiatic
Phoenician 	Semitic Branch 	Afro-Asiatic
Punic 	Semitic Branch 	Afro-Asiatic
Ugaritic 	Semitic Branch 	Afro-Asiatic
Nabatean 	Semitic Branch 	Afro-Asiatic
Amorite 	Semitic Branch 	Afro-Asiatic
Moabite 	Semitic Branch 	Afro-Asiatic
Shluh 	Berber Branch 	Afro-Asiatic
Tamazight 	Berber Branch 	Afro-Asiatic
Riffian 	Berber Branch 	Afro-Asiatic
Kabyle 	Berber Branch 	Afro-Asiatic
Shawia 	Berber Branch 	Afro-Asiatic
Tuareg 	Berber Branch 	Afro-Asiatic
Guanch 	Berber Branch 	Afro-Asiatic
Somali 	Cushitic Branch 	Afro-Asiatic
Galla 	Cushitic Branch 	Afro-Asiatic
Sidamo 	Cushitic Branch 	Afro-Asiatic
Beja 	Cushitic Branch 	Afro-Asiatic
Afar 	Cushitic Branch 	Afro-Asiatic
Saho 	Cushitic Branch 	Afro-Asiatic
Egyptian 	Egyptian Branch 	Afro-Asiatic
Coptic 	Egyptian Branch 	Afro-Asiatic
Hausa 	Chadic Branch 	Afro-Asiatic
Turkish 	Turkic Branch 	Altaic
Azeri 	Turkic Branch 	Altaic
Turkmen 	Turkic Branch 	Altaic
Kazakh 	Turkic Branch 	Altaic
Kirghiz 	Turkic Branch 	Altaic
Tatar 	Turkic Branch 	Altaic
Bashkir 	Turkic Branch 	Altaic
Uzbek 	Turkic Branch 	Altaic
Uigur 	Turkic Branch 	Altaic
Chuvash 	Turkic Branch 	Altaic
Balkar 	Turkic Branch 	Altaic
Nogai 	Turkic Branch 	Altaic
Salar 	Turkic Branch 	Altaic
Mongolian 	Mongolian Branch 	Altaic
Buryat 	Mongolian Branch 	Altaic
Kalmyk 	Mongolian Branch 	Altaic
Evenki 	Tungusic Branch 	Altaic
Lamut 	Tungusic Branch 	Altaic
Manchu 	Tungusic Branch 	Altaic
Nanai 	Tungusic Branch 	Altaic
Sibo 	Tungusic Branch 	Altaic
Korean 	Korean Branch 	Altaic
Japanese 	Japonic Branch 	Altaic
Okinawan 	Japonic Branch 	Altaic
Vietnamese 	Viet-Muong Branch 	Austroasiatic
Muong 	Viet-Muong Branch 	Austroasiatic
Khmer 	Mon-Khmer Branch 	Austroasiatic
Mon 	Mon-Khmer Branch 	Austroasiatic
Palaung 	Mon-Khmer Branch 	Austroasiatic
Wa 	Mon-Khmer Branch 	Austroasiatic
Bahnar 	Mon-Khmer Branch 	Austroasiatic
Sedang 	Mon-Khmer Branch 	Austroasiatic
Khasi 	Mon-Khmer Branch 	Austroasiatic
Nicobarese 	Mon-Khmer Branch 	Austroasiatic
So 	Mon-Khmer Branch 	Austroasiatic
Nancowry 	Mon-Khmer Branch 	Austroasiatic
Sengoi 	Mon-Khmer Branch 	Austroasiatic
Temiar 	Mon-Khmer Branch 	Austroasiatic
Santali 	Munda Branch 	Austroasiatic
Mundari 	Munda Branch 	Austroasiatic
Ho 	Munda Branch 	Austroasiatic
Savara 	Munda Branch 	Austroasiatic
Korku 	Munda Branch 	Austroasiatic
Georgian 	Kartvelian Branch 	Caucasian
Laz 	Kartvelian Branch 	Caucasian
Svan 	Kartvelian Branch 	Caucasian
Chan 	Kartvelian Branch 	Caucasian
Mingrelian 	Kartvelian Branch 	Caucasian
Abaza 	Abkhaz-Adyghean Branch 	Caucasian
Abkhaz 	Abkhaz-Adyghean Branch 	Caucasian
Adyghe 	Abkhaz-Adyghean Branch 	Caucasian
Kabardian 	Abkhaz-Adyghean Branch 	Caucasian
Circassian 	Abkhaz-Adyghean Branch 	Caucasian
Ubykh 	Abkhaz-Adyghean Branch 	Caucasian
Urartian 	Abkhaz-Adyghean Branch 	Caucasian
Chechen 	Nakh Branch 	Caucasian
Ingush 	Nakh Branch 	Caucasian
Tsova-Tush 	Nakh Branch 	Caucasian
Tsez 	Daghestanian Branch 	Caucasian
Hunzib 	Daghestanian Branch 	Caucasian
Beshta 	Daghestanian Branch 	Caucasian
Avar 	Daghestanian Branch 	Caucasian
Andi 	Daghestanian Branch 	Caucasian
Chamali 	Daghestanian Branch 	Caucasian
Lak 	Daghestanian Branch 	Caucasian
Dargwa 	Daghestanian Branch 	Caucasian
Lezgian 	Daghestanian Branch 	Caucasian
Tabasaran 	Daghestanian Branch 	Caucasian
Tsakhur 	Daghestanian Branch 	Caucasian
Brahui 	Central Branch 	Dravidian
Gondi 	Central Branch 	Dravidian
Kurukh 	Central Branch 	Dravidian
Kui 	Central Branch 	Dravidian
Elamite 	Central Branch 	Dravidian
Telugu 	Southern Branch 	Dravidian
Tamil 	Southern Branch 	Dravidian
Kannada 	Southern Branch 	Dravidian
Malayalam 	Southern Branch 	Dravidian
Tulu 	Southern Branch 	Dravidian
Welsh 	Celtic Branch 	Indo-European
Irish Gaelic 	Celtic Branch 	Indo-European
Scottish Gaelic 	Celtic Branch 	Indo-European
Breton 	Celtic Branch 	Indo-European
Cornish 	Celtic Branch 	Indo-European
Gaulish 	Celtic Branch 	Indo-European
Cumbrian 	Celtic Branch 	Indo-European
Manx 	Celtic Branch 	Indo-European
Galatian 	Celtic Branch 	Indo-European
English 	Germanic Branch 	Indo-European
Dutch 	Germanic Branch 	Indo-European
Flemish 	Germanic Branch 	Indo-European
Frisian 	Germanic Branch 	Indo-European
Afrikaans 	Germanic Branch 	Indo-European
German 	Germanic Branch 	Indo-European
Yiddish 	Germanic Branch 	Indo-European
Danish 	Germanic Branch 	Indo-European
Swedish 	Germanic Branch 	Indo-European
Norwegian 	Germanic Branch 	Indo-European
Faroes 	Germanic Branch 	Indo-European
Icelandic 	Germanic Branch 	Indo-European
Anglo Saxon 	Germanic Branch 	Indo-European
Old Norse 	Germanic Branch 	Indo-European
Frankish 	Germanic Branch 	Indo-European
Gothic 	Germanic Branch 	Indo-European
Lombardo 	Germanic Branch 	Indo-European
Visigoth 	Germanic Branch 	Indo-European
Vandal 	Germanic Branch 	Indo-European
Italian 	Romance (Latin) Branch 	Indo-European
Sardinian 	Romance (Latin) Branch 	Indo-European
French 	Romance (Latin) Branch 	Indo-European
Provencal 	Romance (Latin) Branch 	Indo-European
Catalonian 	Romance (Latin) Branch 	Indo-European
Spanish 	Romance (Latin) Branch 	Indo-European
Ladino 	Romance (Latin) Branch 	Indo-European
Galician 	Romance (Latin) Branch 	Indo-European
Portuguese 	Romance (Latin) Branch 	Indo-European
Romansh 	Romance (Latin) Branch 	Indo-European
Romanian 	Romance (Latin) Branch 	Indo-European
Moldavian 	Romance (Latin) Branch 	Indo-European
Latin 	Romance (Latin) Branch 	Indo-European
Oscan 	Romance (Latin) Branch 	Indo-European
Umbrian 	Romance (Latin) Branch 	Indo-European
Faliscan 	Romance (Latin) Branch 	Indo-European
Sabine 	Romance (Latin) Branch 	Indo-European
Dalmatian 	Romance (Latin) Branch 	Indo-European
Russian 	Slavic Branch 	Indo-European
Belorussian 	Slavic Branch 	Indo-European
Ukrainian 	Slavic Branch 	Indo-European
Polish 	Slavic Branch 	Indo-European
Sorbian 	Slavic Branch 	Indo-European
Czech 	Slavic Branch 	Indo-European
Slovak 	Slavic Branch 	Indo-European
Slovene 	Slavic Branch 	Indo-European
Croatian 	Slavic Branch 	Indo-European
Serbian 	Slavic Branch 	Indo-European
Kashubian 	Slavic Branch 	Indo-European
Bulgarian 	Slavic Branch 	Indo-European
Macedonian 	Slavic Branch 	Indo-European
Bosnian 	Slavic Branch 	Indo-European
Old Church Slavic 	Slavic Branch 	Indo-European
Lithuanian 	Baltic Branch 	Indo-European
Latvian 	Baltic Branch 	Indo-European
Prussian 	Baltic Branch 	Indo-European
Modern Greek 	Hellenic Branch 	Indo-European
Mycenaean 	Hellenic Branch 	Indo-European
Koine 	Hellenic Branch 	Indo-European
Byzantine Greek 	Hellenic Branch 	Indo-European
Greek 	Hellenic Branch 	Indo-European
Classical Greek 	Hellenic Branch 	Indo-European
Attic 	Hellenic Branch 	Indo-European
Doric 	Hellenic Branch 	Indo-European
Ionic 	Hellenic Branch 	Indo-European
Aeolic 	Hellenic Branch 	Indo-European
Albanian 	Illyric Branch 	Indo-European
Illyric 	Illyric Branch 	Indo-European
Mesapian 	Illyric Branch 	Indo-European
Hittite 	Anatolian Branch 	Indo-European
Lydian 	Anatolian Branch 	Indo-European
Lycian: Luwian 	Anatolian Branch 	Indo-European
Palaic 	Anatolian Branch 	Indo-European
Armenian 	Thracian Branch 	Indo-European
Dacian 	Thracian Branch 	Indo-European
Thracian 	Thracian Branch 	Indo-European
Phrygian 	Thracian Branch 	Indo-European
Farsi 	Iranian Branch 	Indo-European
Kurdish 	Iranian Branch 	Indo-European
Pashto 	Iranian Branch 	Indo-European
Baluchi 	Iranian Branch 	Indo-European
Ossetian 	Iranian Branch 	Indo-European
Tadzhik 	Iranian Branch 	Indo-European
Persian 	Iranian Branch 	Indo-European
Avestan 	Iranian Branch 	Indo-European
Scythian 	Iranian Branch 	Indo-European
Hindi 	Indic Branch 	Indo-European
Urdu 	Indic Branch 	Indo-European
Nepali 	Indic Branch 	Indo-European
Bengali 	Indic Branch 	Indo-European
Assamese 	Indic Branch 	Indo-European
Oriya 	Indic Branch 	Indo-European
Kashmiri 	Indic Branch 	Indo-European
Punjabi 	Indic Branch 	Indo-European
Sindhi 	Indic Branch 	Indo-European
Marathi 	Indic Branch 	Indo-European
Gujarati 	Indic Branch 	Indo-European
Bhili 	Indic Branch 	Indo-European
Lahnda 	Indic Branch 	Indo-European
Maithili 	Indic Branch 	Indo-European
Magahi 	Indic Branch 	Indo-European
Konkani 	Indic Branch 	Indo-European
Sinhalese 	Indic Branch 	Indo-European
Maldivian 	Indic Branch 	Indo-European
Romany 	Indic Branch 	Indo-European
Sanskrit 	Indic Branch 	Indo-European
Pali 	Indic Branch 	Indo-European
Ardhamagadhi 	Indic Branch 	Indo-European
Turfanian 	Tokharian Branch 	Indo-European
Kuchean 	Tokharian Branch 	Indo-European
Amis 	Formosan Branch 	Malayo-Polinesian
Atayal 	Formosan Branch 	Malayo-Polinesian
Paiwan 	Formosan Branch 	Malayo-Polinesian
Tsou 	Formosan Branch 	Malayo-Polinesian
Indonesian 	Western Branch 	Malayo-Polinesian
Malay 	Western Branch 	Malayo-Polinesian
Javanese 	Western Branch 	Malayo-Polinesian
Sundanese 	Western Branch 	Malayo-Polinesian
Madurese 	Western Branch 	Malayo-Polinesian
Tagalog 	Western Branch 	Malayo-Polinesian
Visayan 	Western Branch 	Malayo-Polinesian
Malagasy 	Western Branch 	Malayo-Polinesian
Achinese 	Western Branch 	Malayo-Polinesian
Batak 	Western Branch 	Malayo-Polinesian
Acehnese 	Western Branch 	Malayo-Polinesian
Buginese 	Western Branch 	Malayo-Polinesian
Balinese 	Western Branch 	Malayo-Polinesian
Ilocano 	Western Branch 	Malayo-Polinesian
Bikol 	Western Branch 	Malayo-Polinesian
Igorot 	Western Branch 	Malayo-Polinesian
Maranao 	Western Branch 	Malayo-Polinesian
Pampangan 	Western Branch 	Malayo-Polinesian
Pangasinan 	Western Branch 	Malayo-Polinesian
Jarai 	Western Branch 	Malayo-Polinesian
Rhade 	Western Branch 	Malayo-Polinesian
Cham 	Western Branch 	Malayo-Polinesian
Marshallese 	Micronesian Branch 	Malayo-Polinesian
Gilbertese 	Micronesian Branch 	Malayo-Polinesian
Chamorro 	Micronesian Branch 	Malayo-Polinesian
Ponapean 	Micronesian Branch 	Malayo-Polinesian
Yapese 	Micronesian Branch 	Malayo-Polinesian
Palau 	Micronesian Branch 	Malayo-Polinesian
Trukese 	Micronesian Branch 	Malayo-Polinesian
Nauruan 	Micronesian Branch 	Malayo-Polinesian
Fijian 	Melanesian Branch 	Malayo-Polinesian
Motu 	Melanesian Branch 	Malayo-Polinesian
Yabim 	Melanesian Branch 	Malayo-Polinesian
Maori 	Polynesian Branch 	Malayo-Polinesian
Uvea 	Polynesian Branch 	Malayo-Polinesian
Samoan 	Polynesian Branch 	Malayo-Polinesian
Tongan 	Polynesian Branch 	Malayo-Polinesian
Niuean 	Polynesian Branch 	Malayo-Polinesian
Rarotongan 	Polynesian Branch 	Malayo-Polinesian
Tahitian 	Polynesian Branch 	Malayo-Polinesian
Tuamotu 	Polynesian Branch 	Malayo-Polinesian
Marquesan 	Polynesian Branch 	Malayo-Polinesian
Hawaiian 	Polynesian Branch 	Malayo-Polinesian
Rapa Nui 	Polynesian Branch 	Malayo-Polinesian
Mende 	Mande Branch 	Niger-Congo
Malinke 	Mande Branch 	Niger-Congo
Bambara 	Mande Branch 	Niger-Congo
Dyula 	Mande Branch 	Niger-Congo
Soninke 	Mande Branch 	Niger-Congo
Susu 	Mande Branch 	Niger-Congo
Kpelle 	Mande Branch 	Niger-Congo
Vai 	Mande Branch 	Niger-Congo
Loma 	Mande Branch 	Niger-Congo
Fulani 	West Atlantic Branch 	Niger-Congo
Wolof 	West Atlantic Branch 	Niger-Congo
Serer 	West Atlantic Branch 	Niger-Congo
Dyola 	West Atlantic Branch 	Niger-Congo
Temne 	West Atlantic Branch 	Niger-Congo
Kissi 	West Atlantic Branch 	Niger-Congo
Gola 	West Atlantic Branch 	Niger-Congo
Balante 	West Atlantic Branch 	Niger-Congo
Mossi 	Voltaic Branch 	Niger-Congo
Gurma 	Voltaic Branch 	Niger-Congo
Dagomba 	Voltaic Branch 	Niger-Congo
Kabre 	Voltaic Branch 	Niger-Congo
Senufo 	Voltaic Branch 	Niger-Congo
Bariba 	Voltaic Branch 	Niger-Congo
Yoruba 	Kwa Branch 	Niger-Congo
Ibo 	Kwa Branch 	Niger-Congo
Ewe 	Kwa Branch 	Niger-Congo
Twi 	Kwa Branch 	Niger-Congo
Fanti 	Kwa Branch 	Niger-Congo
Ga 	Kwa Branch 	Niger-Congo
Adangme 	Kwa Branch 	Niger-Congo
Fon 	Kwa Branch 	Niger-Congo
Edo 	Kwa Branch 	Niger-Congo
Urhobo 	Kwa Branch 	Niger-Congo
Idoma 	Kwa Branch 	Niger-Congo
Nupe 	Kwa Branch 	Niger-Congo
Agni 	Kwa Branch 	Niger-Congo
Baule 	Kwa Branch 	Niger-Congo
Kru 	Kwa Branch 	Niger-Congo
Grebo 	Kwa Branch 	Niger-Congo
Bassa 	Kwa Branch 	Niger-Congo
Swahili 	Bantu Branch 	Niger-Congo
Luba 	Bantu Branch 	Niger-Congo
Kongo 	Bantu Branch 	Niger-Congo
Lingala 	Bantu Branch 	Niger-Congo
Mongo 	Bantu Branch 	Niger-Congo
Ruanda 	Bantu Branch 	Niger-Congo
Rundi 	Bantu Branch 	Niger-Congo
Kikuyu 	Bantu Branch 	Niger-Congo
Kamba 	Bantu Branch 	Niger-Congo
Sukuma 	Bantu Branch 	Niger-Congo
Nyamwezi 	Bantu Branch 	Niger-Congo
Hehe 	Bantu Branch 	Niger-Congo
Chagga 	Bantu Branch 	Niger-Congo
Makonde 	Bantu Branch 	Niger-Congo
Yao 	Bantu Branch 	Niger-Congo
Ganda 	Bantu Branch 	Niger-Congo
Nkole 	Bantu Branch 	Niger-Congo
Chiga 	Bantu Branch 	Niger-Congo
Gisu 	Bantu Branch 	Niger-Congo
Toro 	Bantu Branch 	Niger-Congo
Nyoro 	Bantu Branch 	Niger-Congo
Nyanja 	Bantu Branch 	Niger-Congo
Tumbuka 	Bantu Branch 	Niger-Congo
Bemba 	Bantu Branch 	Niger-Congo
Tonga 	Bantu Branch 	Niger-Congo
Lozi 	Bantu Branch 	Niger-Congo
Lwena 	Bantu Branch 	Niger-Congo
Lunda 	Bantu Branch 	Niger-Congo
Shona 	Bantu Branch 	Niger-Congo
Fang 	Bantu Branch 	Niger-Congo
Bulu 	Bantu Branch 	Niger-Congo
Yaundé 	Bantu Branch 	Niger-Congo
Duala 	Bantu Branch 	Niger-Congo
Bubi 	Bantu Branch 	Niger-Congo
Mbundu 	Bantu Branch 	Niger-Congo
Chokwe 	Bantu Branch 	Niger-Congo
Ambo 	Bantu Branch 	Niger-Congo
Herero 	Bantu Branch 	Niger-Congo
Makua 	Bantu Branch 	Niger-Congo
Thonga 	Bantu Branch 	Niger-Congo
Sotho 	Bantu Branch 	Niger-Congo
Tswana 	Bantu Branch 	Niger-Congo
Pedi 	Bantu Branch 	Niger-Congo
Swazi 	Bantu Branch 	Niger-Congo
Zulu 	Bantu Branch 	Niger-Congo
Matebele 	Bantu Branch 	Niger-Congo
Xhosa 	Bantu Branch 	Niger-Congo
Venda 	Bantu Branch 	Niger-Congo
Efik 	Efik Branch 	Niger-Congo
Ibibio 	Efik Branch 	Niger-Congo
Tiv 	Efik Branch 	Niger-Congo
Mbum 	Adamawan Branch 	Niger-Congo
Zande 	Eastern Branch 	Niger-Congo
Sango 	Eastern Branch 	Niger-Congo
Gbaya 	Eastern Branch 	Niger-Congo
Banda 	Eastern Branch 	Niger-Congo
Ijo Branch 	Eastern Branch 	Niger-Congo
Ijo 	Eastern Branch 	Niger-Congo
Mandarin 	Sinitic Branch 	Sino-Tibetan
Wu 	Sinitic Branch 	Sino-Tibetan
Amoy 	Sinitic Branch 	Sino-Tibetan
Gan 	Sinitic Branch 	Sino-Tibetan
Min 	Sinitic Branch 	Sino-Tibetan
Hakka 	Sinitic Branch 	Sino-Tibetan
Xiang 	Sinitic Branch 	Sino-Tibetan
Cantonese 	Sinitic Branch 	Sino-Tibetan
Yue 	Sinitic Branch 	Sino-Tibetan
Burmese 	Tibeto-Burman Branch 	Sino-Tibetan
Tibetan 	Tibeto-Burman Branch 	Sino-Tibetan
Yi 	Tibeto-Burman Branch 	Sino-Tibetan
Lisu 	Tibeto-Burman Branch 	Sino-Tibetan
Moso 	Tibeto-Burman Branch 	Sino-Tibetan
Lahu 	Tibeto-Burman Branch 	Sino-Tibetan
Karen 	Tibeto-Burman Branch 	Sino-Tibetan
Kachin 	Tibeto-Burman Branch 	Sino-Tibetan
Chin 	Tibeto-Burman Branch 	Sino-Tibetan
Bodo 	Tibeto-Burman Branch 	Sino-Tibetan
Garo 	Tibeto-Burman Branch 	Sino-Tibetan
Meithei 	Tibeto-Burman Branch 	Sino-Tibetan
Lushei 	Tibeto-Burman Branch 	Sino-Tibetan
Newari 	Tibeto-Burman Branch 	Sino-Tibetan
Murmi 	Tibeto-Burman Branch 	Sino-Tibetan
Jonkha 	Tibeto-Burman Branch 	Sino-Tibetan
Lepcha 	Tibeto-Burman Branch 	Sino-Tibetan
Mizo 	Tibeto-Burman Branch 	Sino-Tibetan
Manipuri 	Tibeto-Burman Branch 	Sino-Tibetan
Thai 	Tai Branch 	Sino-Tibetan
Lao 	Tai Branch 	Sino-Tibetan
Chuang 	Tai Branch 	Sino-Tibetan
Puyi 	Tai Branch 	Sino-Tibetan
Tung 	Tai Branch 	Sino-Tibetan
Nung 	Tai Branch 	Sino-Tibetan
Shan 	Tai Branch 	Sino-Tibetan
Kam-Sui 	Tai Branch 	Sino-Tibetan
Zhuang 	Tai Branch 	Sino-Tibetan
Li 	Tai Branch 	Sino-Tibetan
Be 	Tai Branch 	Sino-Tibetan
Hmong 	Southern Branch (Hmong-Mien) 	Sino-Tibetan
Yao 	Southern Branch (Hmong-Mien) 	Sino-Tibetan
She 	Southern Branch (Hmong-Mien) 	Sino-Tibetan
Finnish 	Finnic Branch 	Uralic
Estonian 	Finnic Branch 	Uralic
Mordvin 	Finnic Branch 	Uralic
Udmurt 	Finnic Branch 	Uralic
Mari 	Finnic Branch 	Uralic
Votyak 	Finnic Branch 	Uralic
Komi 	Finnic Branch 	Uralic
Sámi 	Finnic Branch 	Uralic
Karelian 	Finnic Branch 	Uralic
Hungarian 	Ugric Branch 	Uralic
Ostyak 	Ugric Branch 	Uralic
Vogul 	Ugric Branch 	Uralic
Nenets 	Samoyed Branch 	Uralic
Selkup 	Samoyed Branch 	Uralic
Nganasan 	Samoyed Branch 	Uralic
Enets 	Samoyed Branch 	Uralic
Kamas 	Samoyed Branch 	Uralic
Yukaghir Branch 	Samoyed Branch 	Uralic
Yukaghir 	Samoyed Branch 	Uralic